//' ' = Nothing
//'B' = breakable
//'#' = wall

 ###########
#  BBBBBBB  #
# BBBBBBBBB #
#BBBBBBBBBBB#
#BBBBBBBBBBB#
#BBBBBBBBBBB#
#BBBBBBBBBBB#
#BBBBBBBBBBB#
#BBBBBBBBBBB#
#BBBBBBBBBBB#
#BBBBBBBBBBB#
#BBBBBBBBBBB#
# BBBBBBBBB #
#  BBBBBBB  #
 ###########
