//' ' = Nothing
//'B' = breakable
//'#' = wall

 ###########
#S BBBBBBB S#
# BBBBBBBBB #
#BBBBBBBBBBB#
#BBBBBBBBBBB#
#BBBBBBBBBBB#
#BBBBBBBBBBB#
#BBBBBBBBBBB#
#BBBBBBBBBBB#
#BBBBBBBBBBB#
#BBBBBBBBBBB#
#BBBBBBBBBBB#
# BBBBBBBBB #
#S BBBBBBB S#
 ###########
